ACDT 	Australian Central Daylight Savings Time 	+10:30
ACST 	Australian Central Standard Time 	+9:30
ACT 	Acre Time 	-5
ACWST 	Australian Central Western Standard Time 	+8:45
ADT 	Atlantic Daylight Time 	-3
AEDT 	Australian Eastern Daylight Savings Time 	+11
AEST 	Australian Eastern Standard Time 	+10
AFT 	Afghanistan Time 	+4:30
AKDT 	Alaska Daylight Time 	-8
AKST 	Alaska Standard Time 	-9
AMST 	Amazon Summer Time 	-3
AMT 	Amazon Time 	-4
AMT 	Armenia Time 	+4
ART 	Argentina Time 	-3
AST 	Atlantic Standard Time 	-4
AST 	Arabia Standard Time 	+3
AT 	    Atlantic Time 	-4/UTC-3
AWST 	Australian Western Standard Time 	+8
AZOST 	Azores Summer Time 	+0
AZOT 	Azores Standard Time 	-1
AZT 	Azerbaijan Time 	+4
BDT 	Brunei Time 	+8
BIT 	Baker Island Time 	-12
BNT 	Brunei Darussalam Time 	+8
BOT 	Bolivia Time 	-4
BRST 	Brasilia Summer Time 	-2
BRT 	Brasilia Time 	-3
BST 	British Summer Time 	+1
BST 	Bangladesh Standard Time 	+6
BST 	Bougainville Standard Time 	+11
BTT 	Bhutan Time 	+6
CAT 	Central Africa Time 	+2
CCT 	Cocos Islands Time 	+6:30
CDT 	Central Daylight Time 	-5
CDT 	Cuba Daylight Time 	-4
CEST 	Central European Summer Time 	+2
CET 	Central European Time 	+1
CHADT 	Chatham Daylight Time 	+13:45
CHAST 	Chatham Standard Time 	+12:45
CHOST 	Choibalsan Summer Time 	+9
CHOT 	Choibalsan Standard Time 	+8
CHST 	Chamorro Standard Time 	+10
CHUT 	Chuuk Time 	+10
CIST 	Clipperton Island Standard Time 	-8
CIT 	Central Indonesia Time 	+8
CKT 	Cook Island Time 	-10
CLST 	Chile Summer Time 	-3
CLT 	Chile Standard Time 	-4
COST 	Colombia Summer Time 	-4
COT 	Colombia Time 	-5
CST 	Central Standard Time 	-6
CST 	Cuba Standard Time 	-5
CST 	China Standard Time 	+8
CT 	    Central Time 	-6/UTC-5
CVT 	Cape Verde Time 	-1
CWST 	Central Western Standard Time 	+8:45
CXT 	Christmas Island Time 	+7
DAVT 	Davis Time 	+7
DDUT 	Dumont d'Urville Time 	+10
EASST 	Easter Island Summer Time 	-5
EAST 	Easter Island Standard Time 	-6
EAT 	East Africa Time 	+3
ECT 	Ecuador Time 	-5
EDT 	Eastern Daylight Time 	-4
EEST 	Eastern European Summer Time 	+3
EET 	Eastern European Time 	+2
EGST 	Eastern Greenland Summer Time 	+0
EGT 	Eastern Greenland Time 	-1
EIT 	Eastern Indonesian Time 	+9
EST 	Eastern Standard Time 	-5
ET   	Eastern Time 	-5/UTC-4
FET 	Further-eastern European Time 	+3
FJT 	Fiji Time 	+12
FKST 	Falkland Islands Summer Time 	-3
FKT 	Falkland Islands Time 	-4
FNT 	Fernando de Noronha Time 	-2
GALT 	Galapagos Time 	-6
GAMT 	Gambier Islands 	-9
GET 	Georgia Standard Time 	+4
GFT 	French Guiana Time 	-3
GILT 	Gilbert Island Time 	+12
GIT 	Gambier Island Time 	-9
GMT 	Greenwich Mean Time 	+0
GST 	Gulf Standard Time 	+4
GST 	South Georgia Time 	-2
GYT 	Guyana Time 	-4
HADT 	Hawaii-Aleutian Daylight Time 	-9
HAST 	Hawaii-Aleutian Standard Time 	-10
HKT 	Hong Kong Time 	+8
HMT 	Heard and McDonald Islands Time 	+5
HOVST 	Khovd Summer Time 	+8
HOVT 	Khovd Standard Time 	+7
ICT 	Indochina Time 	+7
IDT 	Israel Daylight Time 	+3
IOT 	Indian Chagos Time 	+6
IRDT 	Iran Daylight Time 	+4:30
IRKT 	Irkutsk Time 	+8
IRST 	Iran Standard Time 	+3:30
IST 	Indian Standard Time 	+5:30
IST 	Irish Standard Time 	+1
IST 	Israel Standard Time 	+2
JST 	Japan Standard Time 	+9
KGT 	Kyrgyzstan time 	+6
KOST 	Kosrae Time 	+11
KRAT 	Krasnoyarsk Time 	+7
KST 	Korea Standard Time 	+9
LHDT 	Lord Howe Daylight Time 	+11
LHST 	Lord Howe Standard Time 	+10:30
LINT 	Line Islands Time 	+14
MAGT 	Magadan Time 	+11
MART 	Marquesas Islands Time 	-9:30
MAWT 	Mawson Station Time 	+5
MDT 	Mountain Daylight Time 	-6
MHT 	Marshall Islands 	+12
MIST 	Macquarie Island Station Time 	+11
MIT 	Marquesas Islands Time 	-9:30
MMT 	Myanmar Standard Time 	+6:30
MSK 	Moscow Time 	+3
MST 	Mountain Standard Time 	-7
MST 	Malaysia Standard Time 	+8
MT 	    Mountain Time 	-7/UTC-6
MUT 	Mauritius Time 	+4
MVT 	Maldives Time 	+5
MYT 	Malaysia Time 	+8
NCT 	New Caledonia Time 	+11
NDT 	Newfoundland Daylight Time 	-2:30
NFT 	Norfolk Time 	+11
NPT 	Nepal Time 	+5:45
NRT 	Nauru Time 	+12
NST 	Newfoundland Standard Time 	-3:30
NT 	    Newfoundland Time 	-3:30
NUT 	Niue Time 	-11
NZDT 	New Zealand Daylight Time 	+13
NZST 	New Zealand Standard Time 	+12
OMST 	Omsk Time 	+6
ORAT 	Oral Time 	+5
PDT 	Pacific Daylight Time 	-7
PET 	Peru Time 	-5
PETT 	Kamchatka Time 	+12
PGT 	Papua New Guinea Time 	+10
PHOT 	Phoenix Island Time 	+13
PhST 	Philippine Standard Time 	+8
PHT 	Philippine Time 	+8
PKT 	Pakistan Standard Time 	+5
PMDT 	Saint Pierre and Miquelon Daylight time 	-2
PMST 	Saint Pierre and Miquelon Standard Time 	-3
PONT 	Pohnpei Standard Time 	+11
PST 	Pacific Standard Time 	-8
PT 	    Pacific Time 	-8/UTC-7
PWT 	Palau Time 	+9
PYST 	Paraguay Summer Time 	-3
PYT 	Paraguay Time 	-4
RET 	RÃ©union Time 	+4
ROTT 	Rothera Research Station Time 	-3
SAKT 	Sakhalin Island time 	+11
SAMT 	Samara Time 	+4
SAST 	South African Standard Time 	+2
SBT 	Solomon Islands Time 	+11
SCT 	Seychelles Time 	+4
SGT 	Singapore Time 	+8
SLST 	Sri Lanka Standard Time 	+5:30
SRET 	Srednekolymsk Time 	+11
SRT 	Suriname Time 	-3
SST 	Samoa Standard Time 	-11
SYOT 	Showa Station Time 	+3
TAHT 	Tahiti Time 	-10
TFT 	French Southern and Antarctic Time 	+5
THA 	Thailand Standard Time 	+7
TJT 	Tajikistan Time 	+5
TKT 	Tokelau Time 	+13
TLT 	Timor Leste Time 	+9
TMT 	Turkmenistan Time 	+5
TOT 	Tonga Time 	+13
TRT 	Turkey Time 	+3
TVT 	Tuvalu Time 	+12
ULAST 	Ulaanbaatar Summer Time 	+9
ULAT 	Ulaanbaatar Standard Time 	+8
USZ1 	Kaliningrad Time 	+2
UTC
UYST 	Uruguay Summer Time 	-2
UYT 	Uruguay Standard Time 	-3
UZT 	Uzbekistan Time 	+5
VET 	Venezuelan Standard Time 	-4
VLAT 	Vladivostok Time 	+10
VOLT 	Volgograd Time 	+4
VOST 	Vostok Station Time 	+6
VUT 	Vanuatu Time 	+11
WAKT 	Wake Island Time 	+12
WAST 	West Africa Summer Time 	+2
WAT 	West Africa Time 	+1
WEST 	Western European Summer Time 	+1
WET 	Western European Time 	+0
WFT 	Wallis and Futuna Time 	+12
WGST 	West Greenland Time 	-3
WGST 	West Greenland Summer Time 	-2
WIB 	Western Indonesia Time 	+7
WIT 	Eastern Indonesia Time 	+9
WST 	Western Standard Time 	+8
YAKT 	Yakutsk Time 	+9
YEKT 	Yekaterinburg Time 	+5
